question	answer
帶牙套差不多要幾元	關於治療費用的部分，因個人狀況不同而有異，建議您於門診中與醫師討論，方能得到確切的答覆。請您於牙科門診時間來電（牙科專線04-7255139），由專人為您預約，謝謝~
有顳顎關節問題, 嘴巴無法張開太大, 如果張太大下巴會合不回去,想請問岡山牙科有相關的醫生可以看診嗎?	您好~如果是突發性的下巴合不回去,可以至本院(岡山秀傳)牙科就診復位.如果是習慣性的下巴脫臼,要獲得比較完全的根治(不再容易脫臼)則必須至醫學中心就診,考慮以手術的方式根治.
我有顳顎關節的問題，想要做進一步的檢查和治療，方便提供醫生的看診時間和姓名嗎？謝謝。	您好~關於您的問題，建議預約彰濱秀傳口腔外科劉漢邦醫師門診（劉醫師的門診時間為週一早上、下午、晚上；週四上午；及週五上午。）。請您於牙科門診時間來電（牙科專線04-7812868），由專人為您預約，謝謝~
有沒有作迷你植體+活動假牙，費用要多少?	您好~本院有提供迷你植體+活動假牙的服務，但費用因材質及個人狀況不同而有異，建議您於門診中與醫師討論，方能得到確切的答覆。請您於牙科門診時間來電（牙科專線04-7255139），由專人為您預約，謝謝~
請問做磨牙牙套健保有補助嗎費用大概多少錢有分材質嗎謝謝回答	您好。健保並未補助磨牙牙套的製作，且費用因材質及個人狀況不同而有異，建議您於門診中與醫師討論，方能得到確切的答覆。請您於牙科門診時間來電（牙科專線04-7255139），由專人為您預約，謝謝~
陳醫師你好,上次給你看牙齒狀況(20年假牙咬合會痛那個)我忘記詢問如果要做假牙,假如是45-46-47-48做假牙,45&48做支撐,這樣費用多少?請以最便宜的假牙材質做估價,畢竟20年沒用過假牙咬食物了,要不是裡面蛀牙,轉變成痛到不能睡,我也不想換,而且這3個多月,一直吃克他服寧,我有爬過文看它的副作用,怕怕的!	您好。關於您的提問，近期將由專人致電，就您的狀況予以回覆。
請問欲拔除智齒可掛那幾位醫師的門診另請問預約看診當天即可拔除或是先看診下次再拔如是由診所轉診是否當天即可拔除以上謝謝解答	智齒拔除可預約本院口腔外科進行處置，至於治療計畫，則需經醫師就門診現狀進行評估後方能確認。建議您於牙科門診時間來電（牙科專線04-7255139），由專人為您預約口腔外科，謝謝~
請問貴院有幫人做假牙鑽孔,抽神經嗎? 之前有去過幾家診所&大型醫院,都沒人願意做,不想再花錢做假牙了,這個假牙讓我一朝被蛇咬十年怕草繩,做完到現在咬食物都會痛,已經二十幾年了,現在更誇張了,整天都在痛,照過X光顯示裡面是蛀牙,當初牙醫沒抽神經,害我從沒用過假牙咬過東西!我從網路爬文,有人跟我類似案例,但是他有找到醫生願意幫他鑽孔抽神經再補起來,所以詢問貴願碰碰運氣,看有沒佛心來著的醫師!!感恩!(牙痛要人命啊)	您好，您提到的問題，牽涉到假牙及根管治療項目，需要專業醫師於門診檢查後，才能確認如何治療以解決您的困擾。歡迎您撥打秀傳牙科約診專線04-7255139，感謝您的留言。
我戴牙套的時候照X光~才發現我上兩排智齒~後面肉眼看不到得地方~就是照X光才會看到~多了四五顆小牙齒~這會有什麼影響嗎~我矯正科醫生說不會贏影響可是我覺得不可能不影響~萬一哪天智齒拔了後面小牙齒長大怎辦~而且還看不到~	您所敘述之牙患狀況，仍需由專業醫師於門診做進一步檢查方能確定，建議來電預約，秀傳牙科部醫師將提供您專業諮詢醫療服務。牙科預約專線04-7255139，感謝您的留言。
醫生您好，如果上排第二臼齒牙縫長期有臭味，如果此牙根發炎並與上頷竇相接，是否可能此牙根的臭味會傳到鼻腔，在從鼻子出來？因為我鼻子會呼出臭味，看過牙醫，也無蛀牙與牙周病，唯一只有這顆牙齒有臭味，但牙醫生只讓位定期清洗，鼻內試鏡也無異狀，若真是此科牙齒造成，是否拔掉此牙齒就可以解決。	您好，就您提到牙縫味道及鼻腔味道的問題，建議您至門診，由口腔外科、牙周病科orENT醫師檢查，找出確切的原因，才可能解決您的困擾。
請問唾液囊腫是要看那一科，是耳鼻喉科還是牙科呢？台南市立醫院這邊有雷射除唾液囊腫手術嗎？	謝謝您的提問唾液囊腫掛牙科及耳鼻喉科均可,建議掛牙科,一般牙科即可直接切除,不用使用雷射,一週內即可復原.
在網路上有人推薦黃致翔醫師，但網路預約頁面4/26（三）沒有診，請問是否能夠預約?	陳小姐您好~黃致翔醫師並未在秀傳醫院牙科駐診, 如果是口腔及牙齒的任何問題歡迎您撥打秀傳牙科約診專線04-7255139專人為您安排預約看診, 感謝您的留言.
我上星期五於貴院拔智齒後，因有縫線，一直到現在還是覺得張口困難，有時候甚至會感到些微血味，請問這樣是正常的嗎？會不會太久了？	拔牙後傷口會形血塊,所以口內有血味是正常的.至於張口困難那是因為腫痛造成的,應該過幾天就好了.
我有顳顎關節的問題，有時咬合伴隨臉頰的地方會疼痛，開口閉口也會??響，有一段時間了情況時好時壞，想要做進一步的檢查和治療，方便提供醫生的看診時間和姓名嗎？謝謝。	劉漢邦醫師.看診時間是星期二下午2:00-5:30.
請問牙周病治療好後，牙齦萎縮露出牙根，重建牙齦費用很高嗎，因為是門牙超不美觀？	牙齦萎縮，造成的原因有齒槽骨萎縮、牙肉萎縮、以及牙齒排列等因素。需要診斷是單一因素，或是多重因素造成，才能決定治療計畫，進而討論治療費用。歡迎您來牙科門診，有專業醫師為您診斷，提供客製化治療計畫
全口牙齦，有出現部份一塊一塊紅色斑點刷牙必流血 且牙齦腫痛（約持續兩周了）近日到牙科診所洗牙醫生告訴我 要改看口腔科那我應該掛哪一位醫生好呢？	感謝您的留言，建議您掛牙周病科或家庭牙科門診，秀傳牙科部醫師會提供您專業諮詢醫療服務。牙科預約專線04-7255139，將由專人為您服務。 
您好:最近舌頭不知道為什麼感覺有點痛(沒有任何破洞),舌紋好像也滿明顯的,大概有痛1個星期多了。請問{舌頭}這個部位是要看牙科還是耳鼻喉科丫?如果是牙科有比較建議專門看口腔的牙科醫生嗎?謝謝!	感謝您的留言，建議您掛口腔外科或一般牙科門診，秀傳牙科部醫師會提供您專業諮詢醫療服務。牙科預約專線04-7255139，將由專人為您服務。
拔完智齒鼻腔內一直留血 是口鼻相通了嗎還有貴院的牙醫紙圍巾是都統一不用夾鏈條直接鋪著嗎？	鼻腔流血是否因口鼻相通造成，需於門診做進一步檢查方能確定，建議您回診由醫師做進一步診斷。本院的紙圍巾原則上統一使用夾鏈條固定，並非直接鋪著，感謝您的留言詢問。
請問貴院有提供牙齒美白的醫療服務嗎? 費用怎麼算呢?	本院有提供牙齒美白醫療服務，療程細節及費用，視個人情況會有不同，需經門診與醫師討論而定。歡迎您撥打秀傳牙科約診專線04-7255139，感謝您的留言。
醫師您好因為我們人在越南 前幾天小女兒喊牙疼 看了一下發現牙齦紅 未腫之後觀察了幾天發現牙齦開始長出一顆紅色的突出物 再來變成白色有膿 疼痛越來越嚴重之後今天臉頰有點微腫帶他去找了幾間牙醫 都說因為妹妹太小 沒辦法看 因為怕亂動之類等等的 所以只告知吃止痛藥所以最後只拍了X光照片 不曉得能否給醫師看X光片後 先大概告知目前狀況 因為我有跟先生討論想回台灣看牙(理想牙醫)麻煩了 謝謝	小朋友的牙患狀況，就醫時仍需重拍X光片以利觀察，建議可先致電預約，理想預約專線︰7260426。